 ...................
 .                  
 .!!!!!!  .z++++++. 
 .+..... .......... 
 .          ?.    . 
 ..... +    ?.*  +. 
 .    +.     ..  +. 
 .+ ....    ?.+  .. 
 ..+        ?.+ ... 
 ..... +    ?..  +. 
 .    +.    ?... +. 
    ....    ?.+  .. 
  .         ?.+ ..  
 ....   z   ?.. zz  
....................

